XXXXXXXXXXXXXXXXXXXXXXXXXXXXXXXXXXXXXXXXXXXXXXXXXXXXXXXXXXXXX
P X         X         X   X     X   X         X             X
X X X XXXXX X XXXXXXX X X X XXX X X X XXXXXXX XXX XXXXXXXXX X
X   X X   X   X       X X X   X   X X     X   X   X       X X
X XXX XXX XXXXX XXXXXXX XXXXX XXXXX XXX XXX XXX XXXXXXX XXX X
X   X X   X   X         X     X   X   X X   X X       X     X
X XXX X X X X XXX XXXXX X XXXXXXX XXX X X XXX X XXXXX X XXXXX
X X   X X X X   X X   X X X     X   X   X X   X     X X     X
XXX XXX XXX X XXX X X XXX X XXX XXX X XXX X X XXXXX X XXXXX X
X   X       X X   X X     X X X   X X X   X X     X X X   X X
X XXXXXXXXXXX X XXX XXXXXXX X XXX X XXX XXX X XXX X X X X X X
X X       X   X X X X   X   X X   X   X X   X X   X X   X X X
X X XXXXX X X X X X X X X X X X XXXXX X X XXX XXXXX XXXXX XXX
X   X X   X X X X X X X X X X X X   X   X X X     X X   X   X
X XXX X XXX X X X X X XXX X X X X XXXXXXX X XXXXX X XXX XXX X
X     X X   X X X X X   X X X     X       X X     X X     X X
XXXXX X X XXXXX X X XXX X X XXXXXXX XXXXXXX X XXXXX X XXXXX X
X X   X X X       X   X   X         X   X   X     X X   X   X
X X XXX X X XXXXX XXX X XXXXXXXXXXXXX X X X XXXXX X X X X X X
X   X   X   X   X X   X   X     X     X   X     X X X X X X X
X XXX XXXXXXX X X X XXXXX X XXX XXXXX XXXXXXXXX X X XXX X X X
X X X     X   X X X X     X   X     X X       X X X     X X X
X X XXXXX X XXX XXX X XXXXXXX XXXXX X X XXXXX X X XXX XXX X X
X   X   X   X X X   X X   X   X     X X     X X X     X   X X
XXX X X XXXXX X X XXX X X X XXXXXXX X XXXXX X X XXXXXXX XXX X
X X X X       X   X X X X   X     X X X     X X       X X   X
X X XXX XXXXX XXXXX X X XXXXX XXX X XXX XXXXX XXXXX XXX X XXX
X X   X X   X         X   X   X   X   X     X       X   X X X
X XXX X X X XXXXXXX XXX X X XXX XXXXX XXXXX XXX XXXXX XXX X X
X     X   X   X   X X   X   X   X         X   X X     X   X X
X XXXXXXXXXXX X X X XXXXXXXXX XXXXXXXXXXX XXX XXX XXXXX XXX X
X     X     X X X X         X   X   X   X X   X   X   X X   X
XXXXX X XXX XXX X XXXXXXXXX XXX X X XXX X X XXX XXX X X X X X
X   X X X       X X     X X   X X X X   X X X   X X X   X X X
X X X X XXXXXXXXX X XXX X XXX X X X X XXX X X XXX X XXXXX X X
X X X X     X X   X X   X   X X   X X       X   X   X     X X
X X X X XXX X X XXX X XXXXX X X XXX X XXXXXXXXX X XXXXXXXXX X
X X X X X X X       X   X   X X X   X X     X   X     X     X
X XXX X X X XXXXXXXXXXX X X X X X XXXXX XXX X XXXXXXX X XXXXX
X   X X   X     X     X X X X X X X   X   X X X     X   X   X
XXX X XXXXXXX X X XXX X X XXX X X X X X XXX X X XXX XXXXX X X
X   X       X X X   X X X X   X X   X   X   X   X X       X X
X X XXXXXXX XXX X X XXX X X XXXXXXXXXXXXX X XXXXX XXXXXXXXX X
X X X     X     X X X   X     X     X     X       X   X   X X
X XXX X XXXXXXXXXXX X XXXXXXX X XXX X XXXXXXXXXXX X X X X X X
X   X X       X     X     X     X X X   X           X X X X X
X X X XXXXXXX X X XXXXXXX XXXXXXX X XXX X XXXXXXXXXXX X X X X
X X X X   X   X X       X X   X   X   X X X       X   X X   X
X X X X X X XXX XXXXXXX X X X X X XXX X X X XXXXX XXX X XXX X
X X X X X X   X X     X X   X X X   X X X X X   X   X X X X X
X X X XXX XXX X X X XXX XXXXX XXX X X X X X X XXXXX XXX X X X
X X   X     X X   X X       X   X X     X X X X   X     X   X
X XXXXX XXX X X XXXXX XXXXX XXX XXXXXXXXX X X X X XXXXXXX XXX
X X     X   X X X     X     X X     X   X X X   X       X   X
X XXXXX X XXX X X XXXXX XXXXX XXXXX X X X X XXX XXX XXX XXX X
X     X X X X X X   X           X   X X   X   X X   X     X X
XXXXX X X X X X XXX XXXXXXXXXXXXX XXXXXXXXXXX X X XXXXXXXXX X
X   X X X X X X   X               X       X   X X     X     X
X XXX X X X X XXX XXXXXXXXXXXXXXXXXXX XXX X XXX XXXXX X XXXXX
X       X   X                         X     X       X       K
XXXXXXXXXXXXXXXXXXXXXXXXXXXXXXXXXXXXXXXXXXXXXXXXXXXXXXXXXXXXX
